11111111111111
10110100000011
1P00111C000011
000E1110000001
10000000000001
11111111111111
