11111111111111
1P00C00E000001
11111111111111
