1111111111111
10C00000000E1
1000000001111
1P000000010C1
1000000001111
1111111111111
