11111111111111111111111111111
10000000000000000000000000001
100000000000000E00000C0000P01
10000000000000000000000000011
11111111111111111111111110001
10000000000000000000000000001
1E010000000000000000000000001
11111111111111111111111111111
