1111111111111
100000C000001
1C00001100001
11110011R0C01
1000001110111
1P000011E0011
1000001100011
1111111111111
