1111111111111
100000C000001
1C00001100001
1111001100C01
1000001111111
1P000011E0011
1000001100011
1111111111111
