11111111111111111
11111111111000001
10000000001000001
1P000000E01000001
10000000001000001
10000000001000001
10000000001000001
11111111111111111
