11111111111111
10000000000011
1000C00000C001
1000000E000001
1000C00000C001
1CCCCCCCCCCCC1
11111111111111
