11111111111111
10110100000011
1P00111C000010
100E1110000001
10000000000001
11111111111111
