111111111111
100000000001
1C0001100011
11110110E111
11P101111111
110001111111
111111011111
